#ステージ横幅、縦幅
17,10
#プレイヤー開始位置
1,8
#お宝位置
1,4
#召喚可能なモンスター
0,1
#初期SP
3
#マップ情報
0,0,0,0,0,6,0,0,0,0,0,0,0,0,0,0,4
0,0,0,0,0,6,0,0,0,0,0,0,0,0,0,0,4
0,0,0,0,0,6,0,0,0,0,0,0,0,0,0,0,4
0,0,0,0,0,6,0,0,7,8,8,0,0,0,0,0,4
0,0,0,0,0,6,0,7,5,0,0,0,7,8,0,0,4
8,8,9,0,0,0,0,4,0,0,0,7,5,5,0,0,4
5,5,5,8,0,0,0,4,0,0,7,5,5,5,0,0,4
0,0,0,0,0,0,0,0,0,0,0,0,0,0,0,0,4
8,0,0,0,0,0,0,0,7,8,8,8,9,0,0,0,4
5,8,8,8,8,8,8,8,5,5,5,5,5,8,8,8,5
