#ステージ横幅、縦幅
20,11
#プレイヤー開始位置
4,8,0
#お宝位置
12,3
#召喚可能なモンスター
0,1
#初期SP
9
#マップ情報
0,0,0,0,0,0,0,0,0,0,0,0,0,0,0,0,0,0,0,0
0,0,0,0,0,0,0,0,0,0,0,0,0,0,0,0,0,0,0,0
0,0,0,0,0,0,0,0,0,0,0,8,0,0,0,0,0,0,0,0
0,0,0,0,0,0,0,0,0,0,0,5,0,0,0,0,0,0,0,0
0,0,0,0,0,0,0,0,0,0,0,5,8,8,0,0,0,0,0,0
0,0,0,0,0,0,0,0,0,0,0,0,0,0,8,0,0,7,8,8
0,0,0,0,0,0,0,0,0,7,9,0,0,0,0,0,0,1,2,5
0,0,0,0,0,0,0,0,7,5,5,9,0,0,0,0,0,0,0,4
9,0,0,0,0,0,0,0,0,0,0,0,0,0,0,0,0,0,0,0
6,0,0,7,8,9,0,0,0,0,0,0,0,0,0,0,0,0,0,0
6,0,0,4,5,6,0,0,0,0,0,0,0,0,0,0,0,0,0,0
