#ステージ横幅、縦幅
15,13
#プレイヤー開始位置
12,11
#お宝位置
1,1
#召喚可能なモンスター
0,1
#初期SP
12
#マップ情報
6,0,0,0,0,0,0,0,0,0,0,0,0,0,4
6,0,0,0,0,0,0,0,0,0,0,0,0,0,4
5,8,9,0,0,0,0,0,0,0,0,0,0,0,4
5,5,5,9,0,0,0,0,0,0,0,0,0,0,4
5,5,5,5,8,8,0,0,0,0,0,0,0,0,4
6,0,0,0,0,0,0,0,0,0,0,0,0,0,4
6,0,0,0,0,0,0,0,0,0,0,0,7,8,5
6,0,0,0,0,0,0,0,0,0,0,7,5,5,5
6,0,0,0,0,0,0,0,0,0,8,5,5,5,5
6,0,0,0,0,0,0,0,0,0,0,0,0,0,4
6,0,0,7,9,0,0,0,0,0,0,0,0,0,4
6,0,0,4,5,9,0,0,0,0,0,0,0,0,4
6,0,0,4,5,5,8,8,8,8,8,8,8,8,5
