#ステージ横幅、縦幅
16,12
#プレイヤー開始位置
10,8,1
#お宝位置
9,4
#召喚可能なモンスター
1,1
#初期SP
7
#マップ情報
0,0,0,0,0,0,0,0,0,0,0,0,0,0,0,0
0,0,0,0,0,0,0,0,0,0,0,0,0,0,0,0
9,0,0,0,0,0,0,7,0,0,0,0,0,0,0,0
6,0,0,0,0,0,0,4,0,0,0,0,0,0,0,0
6,0,0,0,0,0,0,4,0,0,0,0,0,0,0,0
6,0,0,0,0,0,0,4,8,8,8,8,0,0,0,0
6,0,0,0,0,0,0,0,0,0,0,0,8,0,0,0
6,0,0,0,0,0,0,0,0,0,0,0,0,0,0,0
0,0,0,0,0,0,0,0,0,0,0,0,0,0,0,0
0,0,0,0,8,0,0,0,7,8,8,9,0,0,0,0
0,0,0,0,5,0,0,0,4,5,5,6,0,0,0,0
0,0,0,0,5,0,0,0,4,5,5,6,0,0,0,0
