#ステージ横幅、縦幅
15,10
#プレイヤー開始位置
13,8,1
#お宝位置
13,3
#召喚可能なモンスター
0,1
#初期SP
6
#マップ情報
0,0,0,0,0,0,0,0,0,0,0,0,0,0,0
0,0,0,0,0,0,0,0,0,0,0,0,0,0,0
0,0,0,0,0,0,0,0,0,0,0,0,0,0,0
0,0,0,0,0,0,0,0,0,0,0,0,0,0,0
0,0,0,0,0,0,8,0,0,0,0,7,8,8,8
0,0,0,0,7,0,5,0,0,0,0,4,5,5,5
0,0,0,7,5,0,5,0,0,0,0,4,5,5,5
8,9,0,0,0,0,0,0,0,0,0,0,0,0,0
5,5,9,0,0,8,0,0,0,0,0,0,0,0,0
5,5,5,8,8,5,8,0,0,0,8,8,8,8,8
