#ステージ横幅、縦幅
19,10
#プレイヤー開始位置
2,6
#お宝位置
17,7
#召喚可能なモンスター
0,1
#初期SP
3
#マップ情報
6,0,0,0,0,0,0,0,0,0,0,0,0,0,0,0,0,0,0
6,0,0,0,0,0,0,0,0,0,0,0,0,0,0,0,0,0,0
6,0,0,0,0,0,0,0,0,0,0,0,0,0,0,0,0,0,0
6,0,0,0,0,0,0,0,0,0,0,0,0,0,0,0,0,0,0
6,0,0,0,0,0,0,0,0,7,9,0,0,0,0,0,0,0,0
6,0,0,0,0,0,0,0,7,5,5,9,0,0,0,0,0,0,0
6,0,0,0,0,0,0,7,5,5,5,5,9,0,0,0,0,0,0
6,0,0,0,0,0,0,0,0,0,0,0,0,0,0,0,0,0,0
6,0,7,8,9,0,0,0,0,0,0,0,0,0,0,0,8,8,8
6,0,4,5,6,0,0,0,0,0,0,0,0,0,0,0,0,0,0
