#ステージ横幅、縦幅
15,11
#プレイヤー開始位置
12,9
#お宝位置
13,2
#召喚可能なモンスター
1,1
#初期SP
5
#マップ情報
6,0,0,0,0,4,5,6,0,0,0,0,0,0,0
6,0,0,0,0,4,5,6,0,0,0,0,0,0,0
6,0,0,0,0,4,5,6,0,0,0,0,0,0,0
6,0,0,0,0,4,5,6,0,0,0,0,7,8,8
6,0,0,0,0,1,2,3,0,0,8,8,5,5,5
0,0,0,0,0,0,0,0,0,0,0,0,0,0,0
8,9,0,0,0,0,0,8,0,8,0,0,0,0,7
5,5,9,0,0,0,0,0,0,0,0,0,0,0,4
5,5,5,9,0,0,0,0,0,0,0,0,0,0,4
5,5,5,5,9,0,0,0,0,0,0,0,0,0,4
5,5,5,5,5,8,8,8,8,8,0,8,8,8,5
