#ステージ横幅、縦幅
15,11
#プレイヤー開始位置
1,9
#お宝位置
13,9
#召喚可能なモンスター
0,0,1
#初期SP
10
#マップ情報
6,0,0,0,0,0,0,0,0,0,0,0,0,0,4
6,0,0,0,0,0,0,0,0,0,0,0,0,0,4
6,0,0,0,0,0,0,0,0,0,0,0,0,0,4
6,0,0,0,0,0,0,0,0,0,0,0,0,0,4
6,0,0,0,0,0,0,0,0,0,0,0,0,0,4
6,0,0,0,0,0,0,0,0,0,0,0,0,0,4
6,0,0,0,0,0,7,9,0,0,0,0,0,0,4
6,0,0,0,0,7,5,6,0,0,0,7,8,8,5
6,0,0,0,7,5,5,6,0,0,0,1,2,2,5
6,0,0,7,5,5,5,6,0,0,0,0,0,0,4
5,8,8,5,5,5,5,5,8,8,8,8,8,8,5
#敵モンスターの出現情報
0,11,9,1
