#ステージ横幅、縦幅
18,11
#プレイヤー開始位置
2,9,0
#お宝位置
16,8
#召喚可能なモンスター
1,1
#初期SP
4
#マップ情報
0,0,0,0,0,0,0,0,0,0,4,6,0,0,0,0,0,0
0,0,0,0,0,0,0,0,0,0,4,6,0,0,0,0,0,0
0,0,0,0,0,0,0,0,0,0,4,6,0,0,0,0,0,0
0,0,0,0,8,8,8,8,8,0,4,6,0,0,0,0,0,0
0,0,9,0,0,0,0,5,5,0,4,6,0,0,0,0,0,0
0,0,5,9,0,0,0,5,5,0,4,6,0,0,0,0,0,0
0,0,5,5,8,0,0,5,5,0,4,6,0,0,0,0,0,0
0,0,0,0,0,0,7,5,5,0,1,3,0,0,0,0,0,0
0,0,0,0,0,8,5,5,5,0,0,0,0,0,0,0,0,0
0,0,0,0,0,0,0,0,0,0,0,0,0,0,0,8,8,8
8,8,8,8,8,8,8,8,0,0,8,0,0,0,0,5,5,5
