#ステージ横幅、縦幅
20,20
#プレイヤー開始位置
17,18
#お宝位置
1,18
#召喚可能なモンスター
1,1,1
#初期SP
11
#マップ情報
5,6,0,0,0,0,0,0,0,0,0,0,0,0,0,0,0,0,0,0
5,3,0,0,0,0,0,0,0,0,0,0,0,0,0,0,0,0,0,0
6,0,0,0,0,0,0,0,0,0,0,0,8,0,8,0,8,8,0,0
5,9,0,8,8,8,9,0,8,0,0,8,0,0,0,0,0,0,0,7
5,3,0,0,0,0,0,8,0,0,8,5,0,0,0,0,0,0,7,5
6,0,0,0,0,0,0,5,8,0,5,0,0,0,0,0,0,8,5,5
6,0,0,0,0,8,0,5,5,0,5,0,0,0,8,8,0,0,0,0
5,8,0,0,0,5,0,6,0,0,0,0,0,0,0,0,8,0,0,0
6,0,0,0,8,5,0,6,0,0,0,0,0,0,0,0,0,8,0,0
6,0,0,0,5,5,0,6,0,0,0,0,0,0,0,0,0,0,0,7
5,8,0,8,5,5,0,6,0,0,0,0,0,0,0,0,8,0,0,4
5,5,8,5,6,0,0,6,0,0,0,0,0,0,0,0,0,8,8,5
5,5,5,5,6,0,7,6,0,0,0,0,0,0,0,0,0,0,0,4
5,5,5,5,6,0,4,5,8,0,8,0,8,0,8,8,0,0,0,1
5,5,5,5,6,0,4,6,0,0,0,0,0,0,0,0,8,0,0,0
5,5,5,5,6,0,4,6,0,0,0,0,0,0,0,0,0,8,0,0
2,2,2,2,3,0,4,6,0,0,0,0,0,0,0,8,0,0,0,7
0,0,0,0,0,0,0,6,0,0,0,0,0,0,0,0,8,8,8,5
9,0,7,8,8,8,8,6,0,0,0,0,0,0,0,0,0,0,0,0
5,8,5,5,5,5,5,5,8,0,8,0,8,0,8,8,8,8,8,8
#敵モンスターの出現情報
1,18,16,1
0,8,18,0
0,8,12,0
1,18,10,1
1,8,4,0
1,7,3,0
0,1,2,0
0,1,5,0
0,1,6,0
0,1,8,0
0,1,9,0
0,4,6,1
0,4,7,1
0,3,8,1
0,3,9,1
0,6,17,1
0,0,17,0
