#ステージ横幅、縦幅
12,9
#プレイヤー開始位置
10,4
#マップ情報
6,0,0,0,0,0,0,0,0,0,0,4
6,0,0,0,0,0,0,0,0,0,0,4
6,0,0,0,0,0,0,0,0,0,0,4
6,0,0,0,0,0,8,0,0,8,0,4
6,8,0,7,9,0,0,0,0,0,0,4
6,0,0,4,5,9,0,0,0,0,0,4
6,0,0,4,5,5,9,0,0,0,0,4
6,0,0,4,5,5,5,9,0,0,0,4
5,8,8,5,5,5,5,5,8,8,8,5
