#ステージ横幅、縦幅
20,20
#プレイヤー開始位置
3,18
#お宝位置
8,1
#召喚可能なモンスター
1,1
#初期SP
8
#マップ情報
0,0,0,0,0,0,0,0,0,0,0,0,0,0,0,0,0,0,0,0
0,0,0,0,0,0,0,0,0,0,0,0,0,0,0,0,0,0,0,0
0,0,0,0,0,0,0,7,8,8,9,0,0,0,0,0,0,0,0,0
0,0,0,0,0,0,0,4,5,5,5,9,0,0,0,8,0,0,0,0
0,0,0,0,0,0,0,4,5,5,5,6,0,0,8,0,0,0,0,0
0,0,0,0,0,0,0,4,5,5,5,5,8,8,5,0,8,0,0,0
0,0,8,8,8,0,0,4,5,6,0,0,0,0,0,0,0,0,7,8
9,0,0,0,0,9,0,1,2,3,0,0,0,0,0,0,0,0,1,5
5,9,0,0,0,6,0,0,0,0,0,0,0,0,0,0,0,0,0,1
5,5,8,0,0,6,0,8,0,8,0,0,0,7,9,0,0,0,0,0
0,0,0,0,7,0,0,0,0,0,0,0,0,4,6,0,0,0,0,0
0,0,0,7,5,0,0,0,0,0,0,0,7,5,6,0,0,0,0,0
0,0,8,5,5,0,0,0,0,0,0,0,1,5,6,0,0,0,0,0
8,0,0,0,0,0,0,0,0,0,0,0,0,1,3,0,0,0,0,0
0,0,0,0,0,0,0,0,0,0,0,0,0,0,0,0,0,0,0,0
0,0,0,0,0,0,0,0,8,8,0,0,0,0,0,0,8,0,0,0
0,0,0,8,8,0,8,0,0,0,0,0,0,0,0,0,0,0,0,0
0,9,0,0,0,0,5,0,0,0,0,0,0,0,0,0,0,0,0,0
0,5,9,0,0,0,0,0,0,0,0,0,0,0,0,0,8,0,0,0
0,5,5,8,8,8,0,0,0,0,0,0,0,0,0,0,5,0,0,0
