#ステージ横幅、縦幅
15,13
#プレイヤー開始位置
12,11
#お宝位置
13,7
#召喚可能なモンスター
1,0
#初期SP
10
#マップ情報
6,0,0,0,0,0,0,0,0,0,0,0,0,0,0
6,0,0,0,0,0,0,0,0,0,0,0,0,0,0
6,0,0,0,0,0,0,0,0,0,0,0,0,0,0
6,0,0,0,0,0,0,0,0,0,0,0,0,0,7
6,0,0,0,0,0,0,0,0,0,0,0,0,0,4
6,0,0,0,0,0,0,7,8,9,0,0,0,0,4
6,0,0,0,0,0,0,4,5,6,0,0,0,0,4
6,0,0,0,0,0,0,4,5,6,0,0,0,0,4
6,0,0,0,0,8,8,5,5,5,8,8,8,8,5
6,0,0,0,8,0,0,0,0,0,0,0,0,0,4
6,0,0,8,0,0,0,0,0,0,0,0,0,0,4
6,0,0,0,0,0,0,0,0,0,0,0,0,0,4
5,8,8,8,8,8,8,8,8,8,8,8,8,8,5
